MFFFWWWWWWWWWWW
WFFWWWWWWWWWWWW
WFFFFFFFFFFFFWW
WWWWFFWWWWWFFWW
WWWFFFFWWWWFFWW
WWWFFWWWWFFFFWW
WWWWWWWFFFFFFWW
WWFFFFFFWWFFFWW
WWFFWWWWWWFFFWW
WWFWWWFFWWWFFFW
WWFFFFFWWWWWFWW
WWWWWFFFFFFFFWW
WWWWFFFFWWFFWWW
WWWWWWWFFFFFWWW
WWWWWWWWWWWWWWW
