WWWWWWWWWWWWWWW
MFFFFFFFWWWWWWW
WFFFFFFFFFFFFWW
WWWWWFWWFFFFFWW
WWWFFFFWWWWFFWW
WWWNWFFFFFFFFWW
WWFFFFFFFWFFFWW
WWFFFFFFWWFFFWW
WWFFWWFFFFFFFWW
WWFWWWFFWWWFFFW
WWFFFFFWWWWWTWW
WWFFWFFFFFFEWWW
WWWWFFFFWWFFWWW
WWFFFFFFFFFFWWW
WWWWWWWGWWWWWWW
