WWWWWWWWWWWWWWW
MFFWWWWWWWWWWWW
WFFFFFFFFFFFFWW
WWWWWFWWWWWFFWW
WWWFFFFWWWWFFWW
WWWNWWWWWFFFFWW
WWWWWWWWWWFFFWW
WWFFFFFFWWFFFWW
WWFFWWWWWWFFFWW
WWFWWWFFWWWFFFW
WWFFFFFWWWWWTWW
WWWWWFFFFFFEWWW
WWWWFFFFWWFFWWW
WWWWWWWFFFFFWWW
WWWWWWWWWWWWWWW
