WWWWWWWWWWWWWWW
WFFFFFFFFFFFFFW
WFWFWFWFWFWFWFW
WFFWFFFWFFFWFFW
WFWFWFWFFWFWFWW
WFWFWFWFWFFWFFW
WFFFWFFWFFWFWFW
WFFFFFFWFWFWFFW
WFWFWFWWFFWFFFW
WFWFWFFFFWFFFFW
WFWFFWFWFFFWFFW
WWWFFFWFWFWWWFW
MFFFWFWFWFWFFFW
WFWFWFFWFFWFFFG
WWWWWWWWWWWWWWW