WWWWWWWWWWWWWWW
WFFFFFFWFFFFFFW
WFWWWWFWFWWWFFW
WFWFFWFWFWFWFFG
WFFFFWFWFWFWFFW
WFFWWWFWFWFWFFW
WWWWFFFFFWFWFFW
WFFFFWWWFWFWFFW
WFWWWWFWWWFWWFW
WFWFFFFFFFFFWFW
WFWFWWWFWWWFWFW
WFWFWFWFWFFFWFW
WFWFWFWFWWWWWFW
MFWFFFWFFFFFFFW
WWWWWWWWWWWWWWW
