WWWWWWWWWWWWWWW
WFFFFFFFFFFFFFW
WFWWFWWWWWWWWFG
WFWFFFFFFFFFWFW
WFWFWWWWWWWFWFW
WFWFWFFFFFWFWFW
WFWFWFWWWFWFWFW
WFWFWFWFWFWFWFW
WFWFWFWFWFWFWFW
MFWFWFWFFFWFWFW
WFWFWFWWWWWFWFW
WFWFWFFFFFFFWFW
WFWFWWWWWFWWWFW
WFWFFFFFFFFFFFW
WWWWWWWWWWWWWWW