WWWWWWWWWWWWWWW
MFFWWWWWWWWWWWW
WFFFFFFFFFFFFWW
WWWFFFWWWWWFFWW
WWWFFFFWWWWFFWW
WWWFFFWWWFFFFFG
WWWWFFWWWWFFFWW
WWFFFFFFWWFFFWW
WFFFFFFFFWWFFWW
WWFWWWFFWWWFFFW
WWFFFFFWWWWWFWW
WWWWWFFFFFFFWWW
WWWWFFFFWWFFWWW
WWWWWWWFFFFFWWW
WWWWWWWWWWWWWWW
