WWWWWWWWWWWWWWW
MFFFFFFFWWWWWWW
WFFFFFFFFFFFFWW
WWWWWFWWFFFFFWW
WWWFFFFWWWWFFWW
WWWWWFFFFFFFFWW
WWWWFFFFFWFFFWW
WFFFWWFFWWFFFWW
WWFFWWFFFFFFFWW
WWFWWWFFWWWFFFW
WFFFFFFWWWWWFWW
WWFFWFFFFFFFFFG
WWWWFFFFWWFFWWW
WFFFFFFFFFFFWWW
WWWWWWWWWWWWWWW
