WWWWWWWWWWWWWWW
MFFFFFFFFFFFFFW
WFWWWWWFWWWWWFW
WFFFFFWFWFFFFFW
WFWFWFWFWFWFWFW
WFWFFFWFWFFFWFW
WFWWWWWFWWWWWFW
WFFFFFFWFFFFFFW
WFWWWWWFWWWWWFW
WFWFFFWFWFFFWFW
WFWFWFWFWFWFWFW
WFFFFFWFWFFFFFW
WFWWWWWFWWWWWFG
WFFFFFFFFFFFFFW
WWWWWWWWWWWWWWW