WWWWWWWWWWWWWWW
MFFFFFFFWWWWWWW
WFFFFFFFFFFFFWW
WWWWWFWWFFFFFWW
WWWFFFFWWWWFFWW
WWWFWFFFFFFFFWW
WWFFFFFFFWFFFFG
WWFFFFFFWWFFFWW
WWFFWWFFFFFFFWW
WWFWWWFFWWWFFFW
WWFFFFFWWWWWFWW
WWFFWFFFFFFFWWW
WWWWFFFFWWFFWWW
WWFFFFFFFFFFWWW
WWwWWWWWWWWWWWW
