WWWWWWWWWWWWWWW
WWFFFFFFFFFFFWW
WFWFFFFFFFFFWFW
WFFWFFFFFFFWFFW
WFFFWFFFFFWFFFW
WFFFFWFFFWFFFFW
WFFFFFWFWFFFFFW
MFWFFFFFFFFWFFG
WFFFFFWFWFFFFFW
WFFFFWFFFWFFFFW
WFFFWFFFFFWFFFW
WFFWFFFFFFFWFFW
WFWFFFFFFFFFWFW
WWFFFFFFFFFFFWW
WWWWWWWWWWWWWWW



