WWWWWWWWWWWWWWW
MFFFFFFFWWWWWWW
WFFFFFFFFFFFFWW
WWWWWFWWFFFFFWW
WWWFFFFWWWWFFWW
WWWFWFFFFFFFFWW
WWFFFFFFFWFFFWW
WWFFFFFFWWFFFWW
WWFFWWFFFFFFFWW
WWFWWWFFWWWFFFW
WWFFFFFWWWWWFWW
WWFFWFFFFFFFWWW
WWWWFFFFWWFFWWW
WWFFFFFFFFFFFFG
WWWWWWWWWWWWWWW
