WWWWWWWWWWWWWWW
MFFFFFFFWWWWFFG
WFFFFFFWFFFFFWW
WWWWWFWWFFFFFWW
WWWFFFFWWWWFFWW
WWWFWFFFFFFFFWW
WWFFFFFFFWFFFWW
WWFFFFFFWWFFFWW
WWFFWWFFFFFFFWW
WWFWFWFFWWWFFFW
WWFFFFFFFWWWFWW
WWFFWFFFFFFFWWW
WWWWFFFFWWFFWWW
WWFFFFFFFFFFWWW
WWWWWWWWWWWWWWW
